favorite,underdog,spread,outcome,fave.name,underdog.name,week
21,13,2,8,TB,MIN,1
27,0,9.5,27,ATL,NO,1
31,0,4,31,BUF,NYJ,1
9,16,4,-7,CHI,GB,1
27,21,4.5,6,CIN,SEA,1
26,10,2,16,DAL,WAS,1
24,17,5,7,DET,SF,1
20,27,6,-7,LAN,HOU,1
20,7,1,13,MIA,PHX,1
28,29,6.5,-1,NE,IND,1
7,9,2.5,-2,LAA,DEN,1
24,10,6,14,PHA,NYG,1
33,37,9.5,-4,PIT,KC,1
14,44,2,-30,CLE,SD,1
30,10,2,20,MIA,PIT,2
31,17,4.5,14,ATL,GB,2
35,3,2.5,32,BUF,IND,2
3,9,3.5,-6,CLE,HOU,2
30,17,10.5,13,DAL,PHX,2
10,13,1,-3,DEN,SEA,2
19,10,3.5,9,KC,TB,2
17,23,7,-6,LAN,NO,2
30,31,4,-1,NYJ,CIN,2
13,3,3.5,10,PHA,NE,2
28,23,7,5,SD,DET,2
28,17,1,11,SF,CHI,2
7,17,6.5,-10,WAS,NYG,2
36,10,2.5,26,LAA,MIN,2
14,20,4,-6,BUF,PHA,3
34,17,9.5,17,ATL,SF,3
28,17,3.5,11,CHI,TB,3
17,20,1,-3,CIN,CLE,3
28,10,3,18,DEN,IND,3
24,26,3.5,-2,DET,MIN,3
10,16,2.5,-6,HOU,MIA,3
35,23,7,12,LAN,GB,3
20,7,3.5,13,NYG,NO,3
20,10,7,10,LAA,SEA,3
38,10,5.5,28,PIT,NYJ,3
40,30,3.5,10,PHX,WAS,3
42,31,4,11,SD,KC,3
35,21,2,14,DAL,NE,3
17,28,2,-11,ATL,CLE,4
24,27,3.5,-3,BUF,CIN,4
18,10,10.5,8,DAL,NYG,4
13,30,3,-17,GB,MIN,4
17,33,3.5,-16,HOU,NYJ,4
31,28,3,3,MIA,IND,4
0,16,1.5,-16,LAA,DET,4
36,13,9,23,PHA,WAS,4
27,21,3.5,6,PIT,NE,4
24,42,3,-18,SD,DEN,4
21,14,6.5,7,SF,NO,4
14,20,2,-6,SEA,KC,4
20,10,1,10,TB,PHX,4
24,7,1,17,LAN,CHI,4
23,17,7,6,BUF,IND,5
17,20,6,-3,DAL,PHX,5
17,10,3.5,7,HOU,CIN,5
27,16,2.5,11,LAN,CLE,5
28,28,6,0,MIA,NYJ,5
24,21,5,3,MIN,CHI,5
33,17,5.5,16,NE,KC,5
14,27,3,-13,NYG,GB,5
0,17,4,-17,LAA,DEN,5
20,6,6.5,14,PIT,NO,5
24,10,9,14,SD,SEA,5
28,10,1,18,TB,DET,5
17,30,2.5,-13,WAS,SF,5
16,13,2,3,PHA,ATL,5
35,37,3.5,-2,ATL,LAN,6
19,41,2,-22,IND,CIN,6
7,24,3.5,-17,CHI,WAS,6
14,45,5,-31,DAL,SF,6
27,21,7,6,DEN,DET,6
10,21,3.5,-11,GB,TB,6
35,17,7,18,HOU,SEA,6
24,28,2.5,-4,NE,NYJ,6
0,27,1,-27,LAA,KC,6
31,14,9,17,PHA,NO,6
13,7,3.5,6,PIT,CLE,6
14,34,1,-20,PHX,NYG,6
31,33,7,-2,SD,MIN,6
31,21,4,10,BUF,MIA,6
41,20,8,21,ATL,PHX,7
14,33,3,-19,BUF,NYJ,7
20,17,10.5,3,CLE,NO,7
29,17,5,12,DAL,LAN,7
14,28,0,-14,DEN,KC,7
13,10,7,3,MIA,WAS,7
38,10,3.5,28,NE,HOU,7
18,16,4,2,LAA,TB,7
23,35,3.5,-12,PHA,MIN,7
7,34,1,-27,PIT,CIN,7
43,14,5,29,SD,IND,7
13,3,1,10,SF,GB,7
0,32,1.5,-32,SEA,NYG,7
48,17,6,31,DET,CHI,7
24,27,8,-3,ATL,NYG,8
9,7,5.5,2,BUF,DEN,8
7,17,6,-10,CIN,NO,8
42,28,7,14,CLE,IND,8
28,27,6,1,DAL,MIA,8
31,27,5,4,DET,GB,8
17,30,2.5,-13,MIN,PHX,8
22,24,3,-2,NE,WAS,8
3,19,9,-16,NYJ,SEA,8
17,28,2,-11,LAA,KC,8
20,10,9,10,PHA,TB,8
17,20,9.5,-3,SD,CHI,8
20,17,0,3,SF,LAN,8
26,13,5.5,13,PIT,HOU,8
41,10,6.5,31,ATL,NO,9
22,13,4,9,BUF,CLE,9
34,21,4,13,CIN,HOU,9
34,24,4,10,GB,SEA,9
20,13,6.5,7,LAN,DET,9
27,10,7.5,17,MIA,IND,9
7,26,2,-19,NYG,NYJ,9
27,17,1,10,LAA,NE,9
14,17,3,-3,PHA,DAL,9
14,17,4.5,-3,PIT,SF,9
22,20,6,2,SD,KC,9
20,10,6,10,TB,CHI,9
42,21,3.5,21,WAS,PHX,9
19,17,5.5,2,DEN,MIN,9
14,17,2.5,-3,ATL,SF,10
23,20,4,3,DEN,CLE,10
26,24,3,2,GB,NYG,10
17,16,0,1,HOU,LAA,10
13,16,8,-3,KC,CHI,10
13,21,11,-8,LAN,NO,10
25,10,4,15,MIN,TB,10
27,30,2.5,-3,NE,MIA,10
41,14,3.5,27,NYJ,IND,10
52,10,4.5,42,PHA,PHX,10
21,24,5,-3,PIT,SEA,10
17,40,4,-23,SD,CIN,10
33,31,2.5,2,WAS,DET,10
27,14,3.5,13,DAL,BUF,10
20,34,5,-14,ATL,PIT,11
0,24,5.5,-24,BUF,PHX,11
24,10,3.5,14,CIN,LAN,11
24,27,3.5,-3,DAL,DET,11
24,7,1,17,DEN,TB,11
21,17,3,4,GB,CHI,11
23,10,5.5,13,KC,HOU,11
17,33,5,-16,MIA,LAA,11
20,10,8.5,10,MIN,NO,11
6,17,2.5,-11,NE,NYJ,11
27,30,1.5,-3,NYG,WAS,11
38,13,14,25,PHA,IND,11
12,15,3,-3,SF,CLE,11
23,44,6,-21,SD,SEA,11
20,17,7,3,BUF,NE,12
38,21,3.5,17,CIN,DEN,12
10,32,2.5,-22,CLE,PIT,12
24,10,7,14,DAL,WAS,12
23,7,2,16,DET,CHI,12
24,27,5.5,-3,HOU,NO,12
40,13,7,27,KC,SEA,12
31,33,3,-2,LAN,SF,12
16,15,2.5,1,NYJ,MIA,12
21,55,3,-34,LAA,SD,12
10,20,9.5,-10,PHA,NYG,12
35,24,2.5,11,PHX,IND,12
37,3,3,34,TB,GB,12
31,30,5,1,ATL,MIN,12
10,9,13.5,1,DAL,CHI,13
27,10,2.5,17,DET,KC,13
31,27,4,4,ATL,HOU,13
21,14,5,7,BUF,WAS,13
41,21,2,20,CIN,CLE,13
23,35,7,-12,MIN,GB,13
20,27,4,-7,NE,PHX,13
25,0,11.5,25,NYJ,IND,13
24,0,6.5,24,PIT,LAN,13
34,17,4,17,SD,DEN,13
17,10,5,7,SF,NYG,13
31,32,1,-1,SEA,LAA,13
31,14,1,17,TB,NO,13
10,13,2.5,-3,PHA,MIA,13
17,13,2.5,4,HOU,CLE,14
23,24,2.5,-1,ATL,TB,14
3,21,7.5,-18,CIN,SF,14
37,13,13,24,DAL,IND,14
16,13,3.5,3,DEN,KC,14
17,31,2.5,-14,DET,GB,14
24,14,6,10,MIA,NE,14
9,10,3.5,-1,MIN,CHI,14
10,7,3.5,3,NYG,LAN,14
23,27,9,-4,NYJ,SEA,14
13,15,4,-2,PHA,WAS,14
30,3,6.5,27,PHX,NO,14
27,28,4,-1,SD,BUF,14
27,30,4,-3,PIT,LAA,14
14,13,2,1,NYJ,CLE,15
45,7,4,38,DET,MIN,15
19,10,3.5,9,BUF,NE,15
21,10,3.5,11,DAL,PHA,15
23,13,9.5,10,DEN,SEA,15
35,7,3,28,GB,NO,15
7,17,2,-10,KC,MIA,15
6,23,6.5,-17,LAA,CHI,15
10,17,1,-7,PIT,CIN,15
10,20,4,-10,PHX,NYG,15
24,23,2.5,1,SD,TB,15
28,6,7,22,SF,HOU,15
38,14,13,24,WAS,IND,15
21,16,3.5,5,LAN,ATL,15
16,6,3,10,MIA,BUF,16
10,13,3,-3,DAL,NYG,16
28,30,2,-2,ATL,CIN,16
24,35,3,-11,DEN,CHI,16
17,20,6,-3,DET,TB,16
21,20,1,1,HOU,PIT,16
6,10,3,-4,MIN,KC,16
21,23,6,-2,NE,IND,16
28,3,3.5,25,NYJ,GB,16
38,0,8.5,38,PHA,PHX,16
21,17,6.5,4,SF,NO,16
42,21,1,21,SEA,CLE,16
30,7,2,23,WAS,LAN,16
23,10,8,13,SD,LAA,16
17,22,4,-5,SF,PHA,1
10,20,2,-10,CIN,LAA,1
6,16,4,-10,NYG,LAN,1
29,41,3,-12,SD,NYJ,1
10,14,7,-4,PIT,DEN,1
23,29,6,-6,NE,IND,1
12,0,4.5,12,MIA,BUF,1
21,27,1.5,-6,CLE,MIN,1
0,11,3,-11,TB,DET,1
28,17,2.5,11,NO,PHX,1
17,20,1,-3,CHI,ATL,1
41,38,4.5,3,GB,HOU,1
17,13,2,4,KC,SEA,1
31,30,2.5,1,DAL,WAS,1
17,48,3.5,-31,MIN,SF,2
13,16,3,-3,ATL,NYG,2
6,10,6.5,-4,CIN,BUF,2
26,31,3.5,-5,DET,CLE,2
17,10,3,7,CHI,TB,2
13,23,0,-10,PHA,WAS,2
34,17,6,17,DAL,PHX,2
21,25,1.5,-4,GB,PIT,2
17,10,2.5,7,DEN,IND,2
34,24,9.5,10,MIA,NE,2
10,17,8,-7,NYJ,SEA,2
20,6,10,14,LAA,HOU,2
30,27,3,3,LAN,NO,2
17,14,4,3,SD,KC,2
17,7,3.5,10,CLE,CIN,3
42,27,3.5,15,SF,PHX,3
27,12,7,15,WAS,KC,3
14,30,3,-16,DET,ATL,3
13,23,6.5,-10,NYJ,NE,3
28,23,5.5,5,BUF,IND,3
40,28,5.5,12,PIT,HOU,3
34,31,3,3,NO,CHI,3
27,24,3,3,GB,LAN,3
28,13,8,15,DAL,NYG,3
10,13,2.5,-3,DEN,PHA,3
19,16,1.5,3,MIN,TB,3
31,34,3,-3,SD,SEA,3
27,14,2,13,LAA,MIA,3
24,20,4.5,4,SF,ATL,4
30,13,7,17,BUF,HOU,4
21,20,8,1,DAL,NO,4
20,17,3,3,MIN,DET,4
17,23,2,-6,TB,CIN,4
11,14,6,-3,PHA,PHX,4
14,6,7.5,8,MIA,KC,4
23,28,8,-5,PIT,NE,4
19,22,2,-3,CHI,IND,4
22,7,3.5,15,LAA,DEN,4
27,24,5.5,3,NYJ,LAN,4
27,17,2,10,WAS,SEA,4
24,30,7,-6,SD,CLE,4
27,3,2,24,NYG,GB,4
33,13,3,20,SF,NE,5
24,28,3.5,-4,ATL,PHA,5
31,14,1.5,17,CHI,DEN,5
37,24,4,13,DAL,MIN,5
55,14,6,41,GB,TB,5
9,24,3,-15,CLE,SEA,5
17,10,11,7,PIT,HOU,5
37,35,2,2,WAS,LAA,5
31,34,6,-3,CIN,IND,5
21,10,4.5,11,LAN,DET,5
7,17,2.5,-10,MIA,NO,5
38,14,2.5,24,KC,PHX,5
34,41,2,-7,NYG,SD,5
34,10,1,24,NYJ,BUF,5
7,10,4.5,-3,SF,LAN,6
17,19,2,-2,ATL,NO,6
38,14,7,24,WAS,PHX,6
14,38,1.5,-24,GB,DET,6
14,23,2,-9,CHI,MIN,6
7,10,2,-3,NYJ,CLE,6
35,38,6,-3,MIA,BUF,6
26,14,1.5,12,DEN,HOU,6
12,7,1,5,IND,NE,6
27,24,14,3,DAL,TB,6
13,17,2,-4,NYG,PHA,6
28,21,3.5,7,SD,SEA,6
21,20,9,1,LAA,KC,6
24,14,1,10,PIT,CIN,6
31,17,3,14,DET,CHI,7
21,37,4,-16,SD,NE,7
27,34,3,-7,TB,PHX,7
14,32,3.5,-18,NYJ,MIA,7
44,17,2,27,PIT,CLE,7
34,14,9,20,MIN,HOU,7
30,7,1,23,BUF,IND,7
24,17,2,7,DEN,CIN,7
27,21,3.5,6,LAN,ATL,7
36,38,3,-2,LAA,SEA,7
38,17,2,21,KC,NYG,7
37,7,7.5,30,DAL,PHA,7
13,32,1,-19,NO,SF,7
47,48,3.5,-1,WAS,GB,7
45,35,1,10,SF,LAN,8
38,40,4,-2,DAL,LAA,8
0,31,4,-31,BUF,NE,8
21,28,0,-7,CLE,CIN,8
38,17,7,21,WAS,DET,8
21,27,3.5,-6,NYJ,ATL,8
6,7,4.5,-1,PHA,CHI,8
17,20,2,-3,GB,MIN,8
13,10,4,3,KC,HOU,8
21,7,3.5,14,MIA,IND,8
24,21,3,3,NO,TB,8
6,14,2,-8,SD,DEN,8
21,27,1,-6,SEA,PIT,8
20,20,2,0,PHX,NYG,8
13,27,6,-14,SF,NYJ,9
24,13,3,11,ATL,NE,9
27,21,2.5,6,BUF,NO,9
25,19,9,6,CLE,HOU,9
17,38,2.5,-21,CHI,DET,9
31,41,3.5,-10,MIN,PHX,9
17,12,10.5,5,PIT,TB,9
21,22,5,-1,PHA,IND,9
30,14,3,16,MIA,LAN,9
38,20,7,18,DAL,NYG,9
34,14,1,20,CIN,GB,9
27,24,2.5,3,DEN,KC,9
21,34,7,-13,LAA,SEA,9
27,24,4.5,3,WAS,SD,9
17,20,2,-3,SF,MIA,10
28,20,3.5,8,LAA,KC,10
27,10,1,17,NO,ATL,10
26,3,5,23,PIT,SD,10
35,21,2,14,GB,CLE,10
21,7,0,14,NE,BUF,10
27,20,6.5,7,DAL,PHA,10
55,14,4,41,CIN,HOU,10
12,17,7,-5,MIN,TB,10
21,14,7,7,LAN,CHI,10
27,19,3,8,SEA,DEN,10
45,7,10,38,WAS,PHX,10
14,17,6.5,-3,NYJ,IND,10
16,9,5,7,DET,NYG,10
15,20,2.5,-5,CIN,KC,11
17,27,6.5,-10,DET,HOU,11
17,14,1,3,CHI,PHA,11
21,29,2.5,-8,MIN,GB,11
28,33,3,-5,SEA,PHX,11
20,0,4,20,CLE,TB,11
6,17,3,-11,MIA,NE,11
17,24,3.5,-7,NYJ,BUF,11
24,13,3.5,11,PIT,IND,11
27,0,4,27,SF,NO,11
22,20,7,2,LAA,DEN,11
33,17,8,16,WAS,NYG,11
23,24,9,-1,DAL,SD,11
13,36,1.5,-23,ATL,LAN,11
37,0,9,37,MIA,IND,12
27,0,1,27,CHI,TB,12
0,30,5,-30,NE,CLE,12
20,23,4,-3,GB,DET,12
38,10,9,28,CIN,HOU,12
27,24,2.5,3,LAA,BUF,12
14,17,7,-3,PIT,MIN,12
0,23,5.5,-23,PHA,NYG,12
44,14,0,30,PHX,SD,12
41,21,9,20,DAL,KC,12
24,28,3.5,-4,SF,ATL,12
38,27,1.5,11,DEN,SEA,12
42,20,3,22,WAS,LAN,12
28,31,3,-3,NO,NYJ,12
3,45,5.5,-42,PIT,DET,13
35,17,10,18,DAL,PHX,13
3,13,5,-10,SF,CHI,13
27,12,9.5,15,LAA,NYG,13
33,24,2,9,TB,HOU,13
26,3,3,23,NYJ,NE,13
41,23,6,18,CLE,IND,13
17,16,2.5,1,NO,MIN,13
28,24,15,4,WAS,PHA,13
47,41,2.5,6,ATL,GB,13
31,7,2.5,24,SD,DEN,13
41,17,4,24,LAN,BUF,13
51,48,3.5,3,SEA,KC,13
38,14,5.5,24,MIA,CIN,13
42,10,1.5,32,LAA,SD,14
35,21,10,14,SF,TB,14
9,13,4.5,-4,LAN,PHA,14
37,21,9.5,16,WAS,ATL,14
0,7,1,-7,NO,NE,14
10,6,0,4,PHX,NYG,14
10,23,4,-13,PIT,CIN,14
24,17,9,7,MIA,HOU,14
9,14,1,-5,KC,BUF,14
31,28,2.5,3,GB,CHI,14
10,6,4,4,NYJ,IND,14
6,27,1.5,-21,CLE,DEN,14
35,10,6,25,DAL,SEA,14
13,2,3,11,DET,MIN,14
7,34,2.5,-27,NYJ,PIT,15
31,24,8,7,MIA,ATL,15
23,10,2,13,SF,BUF,15
24,34,9,-10,LAA,PHX,15
13,19,2,-6,MIN,CHI,15
27,34,6.5,-7,CLE,HOU,15
17,9,3,8,CIN,DET,15
17,20,1,-3,PHA,NO,15
17,12,3,5,SEA,NYG,15
10,31,2.5,-21,DAL,WAS,15
7,21,6.5,-14,LAN,NE,15
41,38,4,3,SD,KC,15
21,19,8.5,2,DEN,IND,15
12,9,4,3,GB,TB,15
34,14,8,20,MIA,NYJ,16
31,22,15.5,9,WAS,NYG,16
14,20,3,-6,CIN,MIN,16
17,48,0,-31,DEN,KC,16
23,21,2.5,2,CHI,GB,16
24,26,3,-2,NO,LAN,16
31,7,6,24,PHX,PHA,16
30,17,3,13,CLE,PIT,16
31,14,2.5,17,ATL,BUF,16
20,10,4.5,10,IND,HOU,16
30,14,8.5,16,LAA,SD,16
24,6,3,18,SEA,NE,16
23,20,9,3,DET,TB,16
42,17,1,25,SF,DAL,16
28,27,2,1,NYG,PHA,1
23,14,2,9,NYJ,IND,1
28,36,6,-8,NO,ATL,1
17,35,4.5,-18,WAS,MIA,1
42,13,3,29,SD,MIN,1
27,37,6.5,-10,PIT,KC,1
30,27,2,3,SF,DET,1
34,14,6,20,CHI,TB,1
24,23,3,1,GB,PHX,1
21,17,3,4,NE,BUF,1
20,17,1,3,DEN,CIN,1
24,14,6,10,LAA,HOU,1
33,0,4.5,33,SEA,CLE,1
13,20,2,-7,LAN,DAL,1
17,23,0,-6,NYJ,PIT,2
7,28,5,-21,DAL,NYG,2
27,0,5,27,CHI,DEN,2
37,7,7,30,PHX,BUF,2
24,27,3,-3,ATL,DET,2
28,7,6,21,MIA,NE,2
19,17,4.5,2,PHA,MIN,2
22,27,4.5,-5,CIN,KC,2
17,13,7,4,NO,TB,2
31,17,2,14,SEA,SD,2
20,17,6,3,LAN,CLE,2
28,7,7,21,LAA,GB,2
21,35,6,-14,HOU,IND,2
37,31,2.5,6,SF,WAS,2
30,14,6,16,WAS,NYG,3
23,43,3,-20,CIN,NYJ,3
38,23,3,15,NE,SEA,3
34,33,5.5,1,PHX,IND,3
20,27,2,-7,ATL,MIN,3
7,9,1.5,-2,GB,CHI,3
22,20,4,2,LAA,KC,3
23,17,8,6,DAL,PHA,3
30,20,5.5,10,SF,NO,3
24,14,3.5,10,PIT,LAN,3
17,21,3.5,-4,DET,TB,3
31,14,10.5,17,SD,HOU,3
14,24,4.5,-10,CLE,DEN,3
21,17,8.5,4,MIA,BUF,3
21,9,4,12,SF,PHA,4
14,24,6,-10,CIN,LAN,4
28,26,1.5,2,NYJ,BUF,4
28,29,6,-1,DET,MIN,4
42,10,9,32,ATL,HOU,4
10,20,2.5,-10,PIT,CLE,4
26,10,1,16,WAS,NE,4
34,24,1,10,NO,PHX,4
21,0,0,21,DEN,KC,4
44,7,11,37,MIA,IND,4
17,14,6,3,NYG,TB,4
20,6,6.5,14,DAL,GB,4
38,9,4,29,SEA,CHI,4
33,30,5.5,3,LAA,SD,4
14,5,5.5,9,SF,ATL,5
31,17,3,14,IND,BUF,5
10,6,5,4,KC,CLE,5
23,14,2.5,9,DAL,CHI,5
36,28,4,8,MIA,PHX,5
21,28,1,-7,NYJ,NE,5
20,12,2,8,SEA,MIN,5
27,24,5,3,SD,DET,5
30,27,3,3,TB,GB,5
13,16,4,-3,LAA,DEN,5
27,10,5.5,17,NO,HOU,5
33,12,3,21,LAN,NYG,5
20,0,9.5,20,WAS,PHA,5
38,17,5.5,21,PIT,CIN,5
35,31,3,4,TB,MIN,6
20,7,3,13,CHI,NO,6
16,17,5,-1,KC,NYJ,6
20,31,6.5,-11,DAL,PHX,6
17,27,1,-10,BUF,PHA,6
7,28,3,-21,DET,DEN,6
31,7,5,24,MIA,PIT,6
17,16,2.5,1,NE,CLE,6
35,7,7.5,28,WAS,IND,6
34,28,3,6,SD,GB,6
13,3,7,10,CIN,HOU,6
28,30,3,-2,LAN,ATL,6
28,14,5,14,LAA,SEA,6
31,10,3.5,21,SF,NYG,6
28,10,17,18,MIA,HOU,7
10,28,3.5,-18,NO,LAN,7
20,24,1,-4,CLE,NYJ,7
16,7,6,9,PHA,IND,7
13,31,2.5,-18,SD,KC,7
38,21,3,17,PHX,CHI,7
13,7,3.5,6,DET,TB,7
7,19,5,-12,ATL,NYG,7
20,14,7.5,6,NE,CIN,7
23,20,10,3,LAA,MIN,7
17,20,9,-3,SF,PIT,7
31,28,11,3,SEA,BUF,7
34,14,5.5,20,WAS,DAL,7
17,14,6.5,3,DEN,GB,7
12,9,3,3,CIN,CLE,8
37,7,3,30,DEN,BUF,8
44,24,4,20,MIA,NE,8
9,44,1,-35,TB,CHI,8
14,16,2,-2,MIN,DET,8
24,26,3.5,-2,WAS,PHX,8
10,24,0,-14,NYG,PHA,8
30,24,1,6,SEA,GB,8
16,17,4.5,-1,PIT,IND,8
28,7,2,21,NYJ,KC,8
44,37,3,7,LAA,SD,8
34,21,10,13,SF,HOU,8
30,27,6,3,DAL,NO,8
10,24,1,-14,ATL,LAN,8
31,13,4,18,CIN,HOU,9
22,3,10,19,DAL,IND,9
30,20,3,10,NE,NYJ,9
24,20,6,4,KC,TB,9
14,16,1.5,-2,CLE,NO,9
16,7,7,9,CHI,MIN,9
34,14,3.5,20,PHX,PHA,9
41,9,2.5,32,GB,DET,9
19,22,6,-3,LAA,DEN,9
35,10,3,25,PIT,ATL,9
33,0,3.5,33,SF,LAN,9
13,37,6,-24,WAS,NYG,9
38,7,18,31,MIA,BUF,9
24,0,0,24,SEA,SD,9
35,7,13.5,28,PIT,HOU,10
13,23,2,-10,NO,GB,10
7,19,7,-12,DAL,NYG,10
23,23,3,0,DET,PHA,10
6,17,2,-11,LAA,CHI,10
38,10,4.5,28,SD,IND,10
13,10,1.5,3,CLE,BUF,10
27,24,2,3,MIN,TB,10
45,0,5.5,45,SEA,KC,10
13,16,6,-3,PHX,LAN,10
26,19,5,7,DEN,NE,10
31,17,7,14,MIA,NYJ,10
23,17,10,6,SF,CIN,10
27,14,10.5,13,WAS,ATL,10
38,10,13.5,28,NE,BUF,11
5,9,9,-4,NYJ,IND,11
28,14,10,14,WAS,DET,11
16,17,13.5,-1,KC,HOU,11
45,17,6.5,28,GB,MIN,11
13,17,1,-4,ATL,NO,11
24,23,15,1,MIA,PHA,11
20,22,1,-2,PIT,CIN,11
41,7,6.5,34,SF,CLE,11
17,24,4.5,-7,PHX,DAL,11
29,13,3,16,LAN,CHI,11
16,13,0,3,DEN,SD,11
17,20,3,-3,NYG,TB,11
17,14,3.5,3,SEA,LAA,11
24,17,12,7,SF,TB,12
50,17,7,33,NE,IND,12
31,6,3,25,GB,LAN,12
3,14,9.5,-11,DAL,BUF,12
7,23,3,-16,ATL,CLE,12
10,16,1,-6,PHX,NYG,12
26,6,4,20,SEA,CIN,12
10,16,7,-6,WAS,PHA,12
16,14,7,2,CHI,DET,12
42,21,9.5,21,DEN,MIN,12
20,31,4.5,-11,NYJ,HOU,12
28,34,7.5,-6,MIA,SD,12
17,7,9.5,10,LAA,KC,12
27,24,1,3,NO,PIT,12
28,31,4,-3,GB,DET,13
20,17,2,3,DAL,NE,13
35,14,6.5,21,CIN,ATL,13
41,14,13.5,27,WAS,BUF,13
27,10,6.5,17,CLE,HOU,13
28,27,7,1,NYG,KC,13
34,33,3,1,LAN,TB,13
17,16,4.5,1,PHX,PHA,13
52,24,2.5,28,PIT,SD,13
34,3,4,31,CHI,MIN,13
21,7,14.5,14,LAA,IND,13
35,3,7.5,32,SF,NO,13
24,27,2.5,-3,DEN,SEA,13
28,17,14,11,MIA,NYJ,13
31,17,10,14,WAS,MIN,14
35,17,13,18,SF,ATL,14
17,20,0,-3,CLE,CIN,14
21,15,3,6,BUF,IND,14
20,10,3.5,10,NYG,NYJ,14
20,23,7,-3,PIT,HOU,14
26,10,4,16,DAL,PHA,14
27,14,6,13,GB,TB,14
13,16,4.5,-3,DEN,KC,14
10,33,4.5,-23,NE,PHX,14
38,17,11,21,SEA,DET,14
34,45,3.5,-11,MIA,LAA,14
34,21,7,13,LAN,NO,14
20,7,1,13,SD,CHI,14
21,17,7,4,NYJ,BUF,15
51,7,16.5,44,SF,MIN,15
23,20,7,3,PIT,CLE,15
23,6,7.5,17,TB,ATL,15
35,17,14,18,MIA,IND,15
24,21,2.5,3,CIN,NO,15
31,21,4,10,PHX,NYG,15
20,14,0,6,GB,CHI,15
7,34,4.5,-27,SEA,KC,15
17,27,3,-10,NE,PHA,15
27,16,11.5,11,LAN,HOU,15
30,28,1,2,WAS,DAL,15
16,13,7,3,DEN,SD,15
24,3,7,21,LAA,DET,15
19,16,6.5,3,SF,LAN,16
3,10,9,-7,NYG,NO,16
14,31,4,-17,SEA,DEN,16
41,21,4,20,TB,NYJ,16
16,10,10,6,NE,IND,16
20,27,2,-7,HOU,CLE,16
29,27,6.5,2,WAS,PHX,16
38,14,7.5,24,GB,MIN,16
52,21,13.5,31,CIN,BUF,16
13,30,0,-17,DET,CHI,16
21,42,2.5,-21,SD,KC,16
10,26,3,-16,PHA,ATL,16
7,13,6,-6,LAA,PIT,16
28,21,6.5,7,MIA,DAL,16
21,0,6.5,21,NYG,PHA,1
31,0,9,31,LAA,NYJ,1
23,26,7.5,-3,MIA,HOU,1
27,24,2.5,3,PHX,CLE,1
21,28,11,-7,SF,MIN,1
27,28,3,-1,ATL,DET,1
28,24,3,4,SEA,CIN,1
47,27,0,20,KC,NO,1
26,20,5,6,NE,GB,1
38,28,7,10,CHI,TB,1
45,3,10,42,PIT,IND,1
14,9,5,5,SD,BUF,1
20,16,1,4,LAN,DEN,1
44,14,1,30,DAL,WAS,1
20,36,2,-16,LAA,KC,2
17,6,4.5,11,LAN,PHA,2
21,26,5,-5,DAL,DET,2
16,13,10,3,WAS,HOU,2
20,7,4.5,13,CHI,NE,2
41,27,4,14,PHX,CIN,2
42,3,3.5,39,NYJ,BUF,2
30,13,17,17,MIA,IND,2
35,16,14,19,SF,ATL,2
16,31,3,-15,TB,MIN,2
23,20,1,3,GB,NYG,2
34,23,10,11,DEN,NO,2
49,35,3.5,14,SEA,SD,2
7,17,2,-10,PIT,CLE,2
33,24,3.5,9,CHI,MIN,3
6,14,5,-8,DET,IND,3
17,14,6,3,NE,BUF,3
6,19,14.5,-13,WAS,PHA,3
27,17,2,10,NYG,PHX,3
44,28,6,16,DEN,ATL,3
41,44,4,-3,CIN,SD,3
20,0,5.5,20,PIT,HOU,3
20,7,7,13,DAL,CLE,3
20,13,2.5,7,NO,TB,3
31,0,4,31,MIA,KC,3
3,24,5.5,-21,GB,NYJ,3
34,10,3,24,SF,LAA,3
24,35,7,-11,SEA,LAN,3
16,10,4.5,6,NYG,PHA,4
45,10,6,35,CHI,WAS,4
43,28,7,15,PHX,GB,4
20,35,1.5,-15,NE,LAA,4
30,9,5,21,DET,TB,4
17,10,5,7,DAL,HOU,4
27,20,3,7,MIN,BUF,4
7,28,2.5,-21,SEA,KC,4
30,26,1,4,MIA,DEN,4
25,20,10,5,NYJ,IND,4
7,21,4.5,-14,SD,CLE,4
17,6,10,11,LAN,ATL,4
17,20,15.5,-3,SF,NO,4
24,37,6.5,-13,PIT,CIN,4
49,17,3.5,32,IND,BUF,5
24,20,7.5,4,MIA,PIT,5
43,10,3.5,33,GB,DET,5
24,20,3.5,4,CLE,NE,5
23,21,3.5,2,NO,PHA,5
38,17,11.5,21,SF,ATL,5
27,19,8.5,8,CHI,TB,5
19,10,2,9,LAA,KC,5
31,20,8.5,11,DEN,HOU,5
20,29,3,-9,CIN,NYJ,5
26,21,13.5,5,SEA,SD,5
13,10,6.5,3,LAN,MIN,5
29,30,1,-1,NYG,DAL,5
10,27,1.5,-17,PHX,WAS,5
15,10,5.5,5,DEN,IND,6
14,3,10,11,NE,BUF,6
7,30,4,-23,PHX,PHA,6
31,27,6.5,4,LAN,TB,6
27,13,6,14,DAL,PIT,6
24,3,9.5,21,WAS,DET,6
30,35,1,-5,NYG,CIN,6
21,6,2.5,15,CLE,HOU,6
20,17,3.5,3,GB,MIN,6
30,26,14,4,SEA,ATL,6
20,31,3.5,-11,KC,SD,6
23,13,9.5,10,LAA,NO,6
10,26,3.5,-16,SF,CHI,6
7,23,3.5,-16,MIA,NYJ,6
17,3,2.5,14,NYG,WAS,7
14,16,4,-2,DAL,PHA,7
21,23,10,-2,SF,DET,7
21,17,3.5,4,MIN,SD,7
24,31,1.5,-7,NO,ATL,7
0,16,1,-16,KC,LAN,7
21,20,2.5,1,LAA,CLE,7
23,10,4,13,PIT,PHX,7
21,9,0,12,BUF,IND,7
27,44,4,-17,CIN,HOU,7
41,38,13.5,3,MIA,TB,7
13,10,3.5,3,DEN,SEA,7
13,20,2,-7,NYJ,NE,7
23,7,9.5,16,CHI,GB,7
21,17,9,4,PHA,BUF,8
10,20,6.5,-10,PHX,HOU,8
24,10,13,14,DAL,ATL,8
32,14,2.5,18,NE,TB,8
21,31,6,-10,MIA,DET,8
27,9,8,18,CHI,MIN,8
17,14,3,3,NYJ,SEA,8
10,37,2,-27,GB,IND,8
7,14,2.5,-7,CLE,WAS,8
30,10,1,20,DEN,KC,8
28,14,0,14,SF,LAN,8
21,26,1.5,-5,PIT,CIN,8
21,13,3.5,8,NYG,NO,8
34,21,6,13,LAA,SD,8
23,17,3.5,6,CIN,BUF,9
22,20,12,2,NYG,TB,9
16,10,8.5,6,CHI,GB,9
13,17,1,-4,MIA,NE,9
44,10,6,34,WAS,ATL,9
16,13,3.5,3,MIN,DET,9
23,20,1,3,HOU,KC,9
10,9,4,1,PIT,CLE,9
10,30,2,-20,DEN,SD,9
33,3,1,30,SEA,LAA,9
28,10,7.5,18,LAN,NO,9
35,17,3.5,18,NYJ,IND,9
24,13,10,11,SF,PHA,9
10,21,4,-11,DAL,PHX,9
28,36,2,-8,KC,PIT,10
27,3,6,24,SEA,NO,10
17,27,5.5,-10,MIN,GB,10
0,20,2.5,-20,HOU,BUF,10
24,19,5,5,NYG,LAN,10
27,10,3,17,CIN,CLE,10
0,16,2.5,-16,PHX,TB,10
24,3,11,21,CHI,DET,10
34,15,9.5,19,NE,IND,10
23,17,9,6,PHA,ATL,10
7,13,2.5,-6,WAS,DAL,10
34,40,2.5,-6,LAA,SD,10
21,17,3.5,4,MIA,NYJ,10
16,17,3,-1,SF,DEN,10
38,14,8,24,GB,NO,11
17,7,8,10,CLE,BUF,11
44,0,0,44,CHI,DAL,11
14,24,2.5,-10,PHX,PHA,11
30,7,3,23,PIT,HOU,11
62,28,10,34,NYJ,TB,11
34,20,8,14,MIA,IND,11
14,30,6,-16,LAN,ATL,11
13,6,6,7,LAA,CIN,11
31,3,12,28,SF,KC,11
13,20,3.5,-7,SEA,NE,11
30,24,5,6,DEN,SD,11
41,21,3.5,20,DET,MIN,11
23,21,1,2,WAS,NYG,11
23,30,5,-7,PIT,WAS,12
23,14,8.5,9,MIA,BUF,12
16,19,1,-3,DET,TB,12
24,6,3,18,CLE,CIN,12
16,13,3.5,3,NYJ,NE,12
36,0,16,36,CHI,ATL,12
23,30,7,-7,MIN,NO,12
35,37,5,-2,SD,HOU,12
20,7,4,13,KC,IND,12
34,17,5.5,17,LAN,GB,12
34,17,6.5,17,DAL,PHA,12
31,28,4.5,3,LAA,DEN,12
34,3,4,31,NYG,PHX,12
19,6,6.5,13,SF,SEA,12
20,31,3,-11,NYJ,DET,13
35,17,14,18,DAL,PHX,13
33,35,6,-2,NYG,CLE,13
23,28,6.5,-5,PHA,MIN,13
23,31,1.5,-8,PIT,DEN,13
45,27,7.5,18,CIN,HOU,13
38,31,6.5,7,NE,IND,13
3,29,5.5,-26,LAN,NO,13
21,0,6.5,21,GB,TB,13
40,7,10,33,SD,BUF,13
35,8,4,27,SF,WAS,13
24,6,8,18,SEA,KC,13
34,24,7,10,LAA,ATL,13
24,38,3.5,-14,CHI,MIA,13
17,10,18,7,CHI,IND,14
17,12,1,5,WAS,PHA,14
23,6,8,17,NE,DET,14
38,10,3.5,28,KC,ATL,14
34,24,4.5,10,MIA,GB,14
28,16,3,12,PHX,NO,14
27,7,9,20,NYJ,BUF,14
24,50,2.5,-26,DAL,CIN,14
14,17,2.5,-3,DEN,LAA,14
35,14,7,21,NYG,HOU,14
31,13,4.5,18,SEA,CLE,14
26,7,6,19,MIN,TB,14
54,44,4,10,SD,PIT,14
20,27,10,-7,SF,LAN,14
19,6,2.5,13,CHI,NYJ,15
14,13,10.5,1,DEN,KC,15
27,24,1.5,3,WAS,CIN,15
13,14,1,-1,MIN,ATL,15
30,24,10,6,PIT,BUF,15
28,21,3,7,DAL,NYG,15
23,31,3.5,-8,TB,IND,15
31,19,9.5,12,SF,NO,15
28,21,9.5,7,CLE,HOU,15
23,26,4.5,-3,DET,GB,15
46,14,9,32,LAN,PHX,15
13,3,4.5,10,LAA,SEA,15
20,14,7,6,SD,PHA,15
30,27,6,3,MIA,NE,15
27,24,1,3,DEN,SEA,16
28,10,8.5,18,NYG,PIT,16
27,16,7,11,WAS,PHX,16
37,10,7,27,NYJ,CLE,16
35,37,2.5,-2,MIN,PHA,16
37,17,7,20,CHI,DET,16
34,23,6,11,NE,CIN,16
28,0,18,28,MIA,BUF,16
10,16,6,-6,NO,ATL,16
38,34,1,4,KC,SD,16
20,17,3,3,GB,TB,16
34,16,5,18,IND,HOU,16
31,16,9,15,SF,DAL,16
16,6,2,10,LAA,LAN,16
28,24,6,4,NYJ,BUF,1
41,14,6,27,WAS,PHA,1
41,31,10,10,CHI,CLE,1
31,7,9,24,SF,TB,1
10,13,3.5,-3,MIN,DET,1
16,10,2.5,6,LAN,PHX,1
10,31,3.5,-21,NO,ATL,1
3,31,4,-28,GB,HOU,1
14,24,1,-10,CIN,KC,1
28,50,2,-22,MIA,SD,1
38,36,3,2,DEN,LAA,1
30,0,6,30,SEA,PIT,1
33,3,9.5,30,NE,IND,1
28,31,1,-3,NYG,DAL,1
6,20,2,-14,NYJ,NE,2
13,16,2,-3,SF,LAN,2
31,7,2,24,DAL,DET,2
10,6,2,4,WAS,LAA,2
36,33,6.5,3,CIN,BUF,2
24,10,2.5,14,NO,GB,2
20,7,3.5,13,NYG,SD,2
33,13,2.5,20,ATL,PHX,2
20,23,1.5,-3,HOU,CLE,2
13,10,16,3,CHI,PHA,2
23,17,5,6,SEA,KC,2
30,10,13.5,20,MIA,IND,2
23,10,2,13,MIN,TB,2
21,10,5.5,11,DEN,PIT,2
13,30,5,-17,CLE,CIN,3
33,7,3.5,26,DEN,PHA,3
31,7,5,24,MIN,PIT,3
24,7,7.5,17,LAN,IND,3
17,10,3,7,BUF,PHX,3
20,24,8,-4,DET,TB,3
35,37,9,-2,DAL,ATL,3
45,51,2.5,-6,MIA,NYJ,3
31,38,6,-7,NE,SEA,3
9,14,3.5,-5,LAA,NYG,3
26,17,10,9,SF,NO,3
27,30,3,-3,SD,WAS,3
27,13,3.5,14,KC,HOU,3
25,12,11,13,CHI,GB,3
16,31,3,-15,MIA,SF,4
20,34,5.5,-14,LAN,PHA,4
17,20,2,-3,BUF,KC,4
16,22,6,-6,HOU,PIT,4
19,14,4,5,WAS,SEA,4
20,17,11,3,NYG,NO,4
24,21,8.5,3,CLE,DET,4
42,7,6.5,35,MIN,GB,4
44,7,4.5,37,CHI,CIN,4
17,13,3,4,LAA,SD,4
26,7,9.5,19,NYJ,IND,4
27,20,3,7,DEN,NE,4
23,20,6,3,ATL,TB,4
31,7,6.5,24,DAL,PHX,4
35,14,17.5,21,SF,IND,5
0,16,6,-16,ATL,PHA,5
27,24,3,3,CLE,PIT,5
24,13,3,11,DET,HOU,5
34,7,6,27,NE,MIA,5
13,6,7.5,7,NYG,PHX,5
14,6,6.5,8,WAS,NO,5
34,28,7,6,CIN,GB,5
23,0,12.5,23,CHI,MIN,5
17,24,0,-7,KC,LAA,5
29,14,3.5,15,DEN,DAL,5
26,20,11,6,LAN,TB,5
14,13,8,1,NYJ,BUF,5
33,7,6,26,SEA,SD,5
24,27,9.5,-3,SF,MIN,6
14,26,1,-12,LAN,ATL,6
17,14,4,3,NO,IND,6
14,10,3.5,4,LAA,SEA,6
31,14,5,17,DEN,SD,6
20,7,4.5,13,CLE,KC,6
27,14,6.5,13,MIA,BUF,6
20,7,13.5,13,CHI,HOU,6
19,30,3,-11,TB,PHX,6
21,14,3,7,DET,GB,6
30,6,0,24,DAL,WAS,6
35,3,7,32,NYG,PHA,6
24,31,7,-7,NE,NYJ,6
24,22,7.5,2,CIN,PIT,6
10,10,3,0,SF,ATL,7
14,10,7,4,LAN,DET,7
38,7,5,31,NO,TB,7
7,23,9.5,-16,CHI,MIN,7
14,17,13,-3,CLE,GB,7
17,14,5,3,DAL,PHA,7
28,21,13,7,WAS,PHX,7
30,28,1,2,LAA,MIA,7
42,41,6,1,KC,SD,7
17,12,3,5,SEA,NYG,7
31,28,6.5,3,CIN,HOU,7
34,0,7,34,NE,PIT,7
24,13,10.5,11,BUF,IND,7
10,22,3.5,-12,DEN,NYJ,7
31,17,9.5,14,SF,GB,8
13,7,15,6,CHI,DET,8
20,23,3.5,-3,MIN,CLE,8
23,3,7.5,20,NE,BUF,8
9,30,4.5,-21,CIN,PIT,8
17,13,9.5,4,MIA,IND,8
27,20,9.5,7,KC,TB,8
28,23,9,5,NYJ,NO,8
28,17,6.5,11,LAA,HOU,8
23,7,4,16,PHA,SD,8
37,6,11,31,DAL,PHX,8
14,7,3.5,7,LAN,ATL,8
20,13,6,7,DEN,SEA,8
27,20,3.5,7,NYG,WAS,8
28,34,0,-6,BUF,TB,9
24,9,6.5,15,CLE,IND,9
17,14,3,3,NYG,DAL,9
10,13,2,-3,PHA,PHX,9
28,7,8,21,MIA,HOU,9
25,17,9,8,NE,ATL,9
27,3,5,24,PIT,GB,9
10,23,6,-13,SF,NO,9
17,24,3,-7,DET,CIN,9
23,24,1.5,-1,SD,KC,9
10,21,3.5,-11,LAA,DEN,9
44,38,7,6,WAS,MIN,9
7,38,4,-31,SEA,NYJ,9
17,20,9.5,-3,CHI,LAN,9
43,17,11,26,SF,PHX,10
16,7,9.5,9,WAS,GB,10
16,12,1,4,BUF,PIT,10
28,14,3,14,NYJ,ATL,10
23,3,10.5,20,CHI,TB,10
30,21,13,9,NE,IND,10
0,6,3,-6,LAN,NO,10
28,32,4,-4,CIN,HOU,10
27,7,1,20,KC,SEA,10
24,10,3,14,MIN,DET,10
17,14,3.5,3,NYG,PHA,10
3,9,14,-6,DEN,SD,10
13,17,3,-4,DAL,LAA,10
26,16,3,10,CLE,MIA,10
13,10,7,3,CHI,ATL,11
34,7,3,27,CIN,SEA,11
24,21,6.5,3,DAL,SD,11
38,17,8,21,DEN,KC,11
31,7,4,24,GB,TB,11
27,14,6.5,13,LAA,CLE,11
34,24,1.5,10,MIA,BUF,11
30,28,2.5,2,NE,LAN,11
16,7,3,9,NO,PHX,11
22,20,1.5,2,NYG,MIN,11
31,16,16,15,NYJ,IND,11
11,13,3.5,-2,PHA,DET,11
21,10,4.5,11,PIT,HOU,11
14,6,2.5,8,WAS,SF,11
37,31,6.5,6,CLE,PIT,12
20,0,10,20,SF,ATL,12
41,14,3,27,WAS,DAL,12
37,31,6,6,LAA,SD,12
22,19,13,3,NE,BUF,12
12,10,14,2,CHI,GB,12
19,16,3,3,NYG,DEN,12
38,17,3.5,21,DET,TB,12
31,17,7,14,HOU,IND,12
24,20,3.5,4,CIN,MIN,12
14,23,4,-9,KC,PHX,12
26,13,6.5,13,LAN,NO,12
24,20,6,4,SEA,PHA,12
3,45,1.5,-42,NYJ,MIA,12
40,44,6,-4,DET,GB,13
14,31,8,-17,DAL,SEA,13
13,10,7,3,CLE,HOU,13
14,17,6.5,-3,KC,BUF,13
21,20,3,1,NE,NO,13
17,3,6.5,14,SD,IND,13
3,17,2.5,-14,NYJ,LAN,13
45,13,12,32,MIN,TB,13
20,17,7.5,3,WAS,PHX,13
13,10,10.5,3,CHI,PIT,13
14,20,9,-6,MIA,ATL,13
27,33,11,-6,LAA,PHA,13
34,28,7.5,6,DEN,CIN,13
17,21,3.5,-4,SF,NYG,13
24,10,6,14,SF,NYJ,14
27,31,3.5,-4,NO,MIA,14
23,28,11,-5,ATL,IND,14
10,37,5,-27,DEN,KC,14
21,17,3,4,CLE,BUF,14
32,6,3,26,MIN,GB,14
7,31,5,-24,NE,CIN,14
27,17,4.5,10,PIT,DET,14
10,10,4.5,0,PHA,PHX,14
48,14,17,34,CHI,TB,14
14,24,3.5,-10,WAS,NYG,14
27,0,7,27,SD,HOU,14
29,10,5,19,LAN,DAL,14
0,37,2.5,-37,LAA,SEA,14
31,30,3,1,DEN,WAS,15
24,45,6.5,-21,NYJ,PIT,15
29,24,2.5,5,SF,NE,15
31,37,6.5,-6,LAN,MIA,15
14,9,1,5,NO,ATL,15
21,7,3.5,14,GB,TB,15
21,23,6.5,-2,DAL,PHA,15
27,7,10.5,20,NYG,PHX,15
17,20,6.5,-3,LAA,KC,15
24,34,2.5,-10,SD,SEA,15
3,34,3.5,-31,CIN,CLE,15
14,24,4,-10,BUF,IND,15
10,23,7,-13,MIN,HOU,15
16,13,10,3,CHI,DET,15
24,14,5,10,SF,LAN,16
55,24,11.5,31,NYG,GB,16
41,16,3.5,25,SEA,DEN,16
24,10,3,14,CHI,DAL,16
6,20,3,-14,DET,ATL,16
33,17,3,16,MIN,NO,16
21,17,12.5,4,PHX,TB,16
21,14,3,7,WAS,PHA,16
52,21,7,31,CIN,NYJ,16
47,17,6.5,30,CLE,SD,16
16,7,3.5,9,HOU,BUF,16
24,30,9,-6,LAA,IND,16
19,24,2,-5,PIT,KC,16
27,34,3.5,-7,MIA,NE,16
28,3,6,25,NE,NYJ,1
34,7,4,27,CHI,MIA,1
21,14,5.5,7,CIN,PHX,1
6,3,3,3,CLE,KC,1
14,21,4,-7,DEN,SEA,1
31,17,5,14,DET,ATL,1
14,17,3.5,-3,IND,HOU,1
24,13,5.5,11,LAA,SD,1
34,7,3.5,27,LAN,GB,1
10,13,3,-3,MIN,BUF,1
33,34,0,-1,NO,SF,1
41,14,6.5,27,PHA,TB,1
24,21,3,3,PIT,DAL,1
27,20,2,7,NYG,WAS,1
36,6,6.5,30,MIN,NE,2
9,6,3.5,3,BUF,MIA,2
17,13,1.5,4,CHI,IND,2
3,23,9.5,-20,CLE,NYJ,2
34,3,12.5,31,DEN,SD,2
10,13,6.5,-3,GB,TB,2
38,35,3,3,HOU,LAA,2
17,10,10,7,LAN,DET,2
29,21,8.5,8,NO,ATL,2
17,20,2,-3,NYG,SF,2
24,28,5,-4,PHA,CIN,2
31,10,7.5,21,SEA,KC,2
30,29,7.5,1,WAS,PIT,2
14,17,2.5,-3,PHX,DAL,2
14,16,2.5,-2,NE,BUF,3
7,31,3,-24,CHI,MIN,3
13,20,5.5,-7,DEN,KC,3
3,45,1.5,-42,HOU,NYJ,3
17,22,0,-5,LAA,LAN,3
24,17,10,7,MIA,GB,3
22,14,5.5,8,NO,DET,3
12,10,3,2,NYG,DAL,3
30,24,3,6,PHX,TB,3
12,17,2.5,-5,PIT,CIN,3
17,34,14,-17,SF,ATL,3
6,17,8,-11,SEA,SD,3
17,10,5,7,WAS,PHA,3
23,17,2,6,CLE,IND,3
31,6,3.5,25,HOU,NE,4
36,28,4,8,BUF,PIT,4
24,6,6,18,CHI,GB,4
24,17,3.5,7,CIN,CLE,4
26,20,6.5,6,DAL,ATL,4
15,13,2,2,IND,MIA,4
23,24,6.5,-1,KC,SD,4
23,21,6,2,MIN,PHA,4
13,9,13.5,4,NO,TB,4
31,45,3.5,-14,NYG,LAN,4
17,10,1.5,7,NYJ,DET,4
38,7,2,31,SF,SEA,4
21,30,5.5,-9,WAS,PHX,4
27,30,7,-3,DEN,LAA,4
21,17,2,4,NE,IND,5
24,3,4,21,CHI,BUF,5
12,0,4,12,DEN,SD,5
21,45,2,-24,LAA,CIN,5
27,41,7,-14,LAN,PHX,5
7,24,3,-17,MIN,MIA,5
17,17,5.5,0,NYJ,KC,5
32,23,4,9,PHA,HOU,5
9,23,2.5,-14,PIT,CLE,5
20,13,13.5,7,SF,DET,5
31,20,4,11,SEA,ATL,5
27,24,2,3,TB,GB,5
23,24,3.5,-1,WAS,NYG,5
20,17,6.5,3,NO,DAL,5
3,45,2.5,-42,NE,GB,6
34,23,5,11,BUF,IND,6
24,7,7,17,CHI,DET,6
36,19,6,17,CIN,NYJ,6
10,16,3.5,-6,CLE,SEA,6
7,6,5,1,HOU,KC,6
14,24,2,-10,LAA,MIA,6
33,0,6.5,33,LAN,ATL,6
14,13,13,1,MIN,TB,6
23,17,5,6,NO,SD,6
31,14,6,17,PHX,PIT,6
13,16,6,-3,SF,DEN,6
35,17,1.5,18,WAS,DAL,6
24,13,2,11,PHA,NYG,6
21,27,5,-6,CIN,NE,7
17,7,7,10,CHI,DAL,7
19,3,2,16,CLE,PHA,7
30,14,13,16,DEN,ATL,7
35,31,6,4,IND,TB,7
17,27,3.5,-10,KC,LAA,7
21,24,1.5,-3,LAN,SF,7
31,28,9.5,3,MIA,SD,7
14,34,10,-20,MIN,GB,7
30,10,10.5,20,NYG,DET,7
14,34,0,-20,PIT,HOU,7
19,20,2.5,-1,SEA,NO,7
33,17,6.5,16,WAS,PHX,7
14,37,2.5,-23,NYJ,BUF,7
23,20,6,3,BUF,NE,8
44,21,5,23,CIN,HOU,8
21,29,0,-8,PHX,CLE,8
21,39,4,-18,DEN,PIT,8
6,7,6.5,-1,KC,DET,8
31,10,4.5,21,LAN,SEA,8
30,44,4.5,-14,MIA,NYJ,8
49,20,3.5,29,MIN,TB,8
20,6,5,14,NO,LAA,8
23,16,7.5,7,NYG,ATL,8
24,23,5.5,1,PHA,DAL,8
0,16,0,-16,SD,IND,8
20,17,5,3,WAS,GB,8
10,9,2.5,1,CHI,SF,8
7,30,5,-23,CHI,NE,9
24,27,11,-3,PHA,ATL,9
23,16,3,7,CLE,CIN,9
28,0,7,28,BUF,GB,9
10,12,2,-2,NO,LAN,9
17,14,3.5,3,MIA,TB,9
10,16,3,-6,DAL,PHX,9
24,20,5,4,NYJ,PIT,9
13,10,7,3,NYG,DET,9
17,14,8,3,SEA,SD,9
24,21,4,3,SF,MIN,9
17,10,6.5,7,LAA,KC,9
17,41,1,-24,WAS,HOU,9
55,23,0,32,IND,DEN,9
21,10,3,11,NE,MIA,10
29,21,6,8,NYG,DAL,10
44,17,10.5,27,MIN,DET,10
20,0,3,20,ATL,GB,10
24,30,1,-6,LAN,PHA,10
42,7,8,35,CIN,PIT,10
28,10,9.5,18,CHI,TB,10
23,24,3,-1,SF,PHX,10
38,14,4,24,IND,NYJ,10
27,24,4,3,WAS,NO,10
17,11,8,6,DEN,KC,10
13,3,0,10,BUF,SEA,10
13,3,3,10,LAA,SD,10
24,17,0,7,HOU,CLE,10
13,14,2,-1,NYJ,NE,11
14,34,3.5,-20,WAS,CHI,11
28,31,6.5,-3,CIN,KC,11
20,13,4,7,IND,GB,11
27,26,3,1,PHA,PIT,11
7,10,5.5,-3,ATL,SD,11
20,23,2.5,-3,DET,TB,11
3,9,6.5,-6,SF,LAA,11
10,14,3.5,-4,LAN,NO,11
24,17,1,7,PHX,NYG,11
7,30,3,-23,CLE,DEN,11
27,24,1,3,SEA,HOU,11
43,3,3.5,40,MIN,DAL,11
31,6,0,25,BUF,MIA,11
3,6,3,-3,MIA,NE,12
27,15,7,12,CHI,TB,12
38,24,4.5,14,CIN,DAL,12
42,0,5,42,NO,DEN,12
9,19,4,-10,GB,DET,12
12,3,4.5,9,MIN,IND,12
9,6,7,3,BUF,NYJ,12
38,20,5.5,18,HOU,PHX,12
27,7,8.5,20,CLE,PIT,12
24,27,2.5,-3,SEA,KC,12
24,38,11,-14,LAN,SD,12
17,23,3,-6,NYG,PHA,12
6,12,8.5,-6,LAA,ATL,12
37,21,3.5,16,SF,WAS,12
23,0,6.5,23,MIN,DET,13
25,17,5,8,HOU,DAL,13
24,21,3.5,3,IND,NE,13
35,21,3.5,14,CIN,BUF,13
13,17,2,-4,WAS,CLE,13
16,0,13,16,CHI,GB,13
16,10,2,6,PIT,KC,13
38,34,2.5,4,NYJ,MIA,13
31,21,6,10,PHA,PHX,13
17,10,5,7,ATL,TB,13
48,10,6.5,38,SF,SD,13
35,24,0,11,DEN,LAN,13
12,13,5,-1,NO,NYG,13
35,27,3,8,SEA,LAA,13
13,7,5,6,NE,SEA,14
5,10,6,-5,BUF,TB,14
24,21,8,3,CLE,DAL,14
30,14,2,16,DET,GB,14
31,28,1,3,IND,MIA,14
45,3,6,42,MIN,NO,14
44,7,2,37,NYG,PHX,14
27,10,13,17,CIN,SD,14
13,3,4,10,SF,ATL,14
19,20,5,-1,PHA,WAS,14
34,38,1,-4,NYJ,KC,14
21,20,2,1,LAA,DEN,14
34,37,8,-3,HOU,PIT,14
3,23,2,-20,CHI,LAN,14
16,34,3,-18,IND,NYJ,15
17,23,1.5,-6,PHX,PHA,15
10,7,9,3,NE,TB,15
41,6,1.5,35,HOU,CIN,15
17,24,7,-7,WAS,DAL,15
13,12,10,1,CHI,DET,15
28,12,9.5,16,NYG,KC,15
37,21,6.5,16,BUF,LAA,15
6,18,10.5,-12,MIN,GB,15
30,17,6.5,13,SF,NO,15
20,14,1,6,SD,PIT,15
22,7,7.5,15,LAN,ATL,15
42,14,3.5,28,SEA,DEN,15
31,38,5,-7,CLE,MIA,15
21,10,0,11,DEN,NE,16
20,17,7,3,CIN,WAS,16
10,9,7.5,1,NO,ATL,16
14,17,3,-3,BUF,IND,16
21,10,3,11,TB,DET,16
28,23,2,5,CLE,HOU,16
40,24,2,16,PIT,MIA,16
21,27,6,-6,NYG,NYJ,16
23,7,2,16,PHA,DAL,16
37,43,2.5,-6,LAA,SEA,16
24,13,2,11,SD,KC,16
17,26,6.5,-9,PHX,GB,16
16,38,6,-22,SF,LAN,16
28,27,7,1,MIN,CHI,16
27,24,4,3,BUF,MIA,1
17,14,3,3,CHI,CIN,1
51,0,2.5,51,CLE,PIT,1
28,0,5.5,28,NO,DAL,1
38,7,5.5,31,MIN,HOU,1
34,20,6,14,DEN,KC,1
31,21,6,10,LAN,ATL,1
24,27,2.5,-3,NYJ,NE,1
16,13,1.5,3,PHX,DET,1
40,14,3.5,26,LAA,SD,1
30,24,3,6,SF,IND,1
31,7,5.5,24,PHA,SEA,1
21,23,3,-2,GB,TB,1
24,27,4,-3,WAS,NYG,1
27,21,1.5,6,ATL,DAL,2
24,14,11,10,NYG,DET,2
34,27,4,7,HOU,SD,2
31,17,6,14,LAN,IND,2
24,19,2,5,KC,LAA,2
10,24,6,-14,NE,MIA,2
38,7,0,31,CHI,MIN,2
34,35,4.5,-1,NO,GB,2
38,24,7,14,CLE,NYJ,2
37,42,3,-5,WAS,PHA,2
24,34,7,-10,SEA,PHX,2
41,10,10,31,CIN,PIT,2
20,16,7.5,4,SF,TB,2
14,28,6.5,-14,BUF,DEN,2
13,9,7.5,4,IND,ATL,3
41,47,3.5,-6,HOU,BUF,3
47,27,7,20,CHI,DET,3
41,38,10,3,LAN,GB,3
21,6,2.5,15,SD,KC,3
31,21,6.5,10,DEN,LAA,3
14,27,8.5,-13,MIN,PIT,3
10,20,2.5,-10,NO,TB,3
33,40,4,-7,MIA,NYJ,3
35,7,7.5,28,NYG,PHX,3
28,38,1.5,-10,PHA,SF,3
3,24,3.5,-21,NE,SEA,3
30,7,4.5,23,WAS,DAL,3
21,14,4,7,CIN,CLE,3
23,21,7,2,GB,ATL,4
21,17,5,4,CIN,KC,4
16,13,5.5,3,CLE,DEN,4
10,17,3,-7,NYJ,IND,4
12,13,5,-1,SF,LAN,4
39,7,7,32,HOU,MIA,4
31,10,7,21,BUF,NE,4
30,13,7,17,NYG,DAL,4
3,23,2.5,-20,DET,PIT,4
13,24,4,-11,PHX,SD,4
20,24,1,-4,LAA,SEA,4
17,3,8,14,MIN,TB,4
16,14,1.5,2,WAS,NO,4
27,13,3.5,14,CHI,PHA,4
26,14,10.5,12,LAN,ATL,5
14,37,0,-23,BUF,IND,5
35,42,4.5,-7,CHI,TB,5
26,16,4,10,CIN,PIT,5
10,13,3.5,-3,CLE,MIA,5
31,13,7,18,GB,DAL,5
24,17,12,7,MIN,DET,5
13,23,4,-10,HOU,NE,5
16,20,7,-4,SEA,KC,5
24,20,4,4,SF,NO,5
21,19,3,2,PHA,NYG,5
30,28,9.5,2,WAS,PHX,5
16,10,7,6,DEN,SD,5
7,14,3,-7,NYJ,LAA,5
16,17,6,-1,TB,DET,6
26,14,6.5,12,MIN,GB,6
28,33,7,-5,CHI,HOU,6
14,3,5,11,DEN,IND,6
20,14,3,6,LAA,KC,6
13,20,7.5,-7,CIN,MIA,6
16,15,2.5,1,ATL,NE,6
29,14,5.5,15,NO,NYJ,6
17,5,3.5,12,PHA,PHX,6
7,17,9,-10,CLE,PIT,6
31,14,14,17,SF,DAL,6
16,17,0,-1,SD,SEA,6
20,17,3,3,NYG,WAS,6
20,23,3.5,-3,LAN,BUF,6
34,20,2,14,PHX,ATL,7
36,28,9,8,KC,DAL,7
21,24,3,-3,SEA,DEN,7
23,20,3,3,MIA,GB,7
12,23,6.5,-11,CIN,IND,7
10,7,6.5,3,PHA,LAA,7
20,7,7.5,13,MIN,DET,7
37,20,11,17,SF,NE,7
21,40,7,-19,LAN,NO,7
20,13,4,7,NYG,SD,7
34,3,7,31,BUF,NYJ,7
27,0,10,27,HOU,PIT,7
32,28,8,4,WAS,TB,7
27,7,1,20,CLE,CHI,7
20,13,7,7,NO,ATL,8
23,20,6.5,3,GB,DET,8
28,17,2.5,11,CLE,HOU,8
23,17,2,6,PIT,KC,8
20,10,2.5,10,CHI,LAN,8
31,17,4,14,BUF,MIA,8
20,23,6,-3,IND,NE,8
24,28,3,-4,DEN,PHA,8
19,10,4,9,PHX,DAL,8
10,7,6,3,SEA,SD,8
23,10,8.5,13,SF,NYJ,8
56,23,6.5,33,CIN,TB,8
24,37,2,-13,WAS,LAA,8
24,14,2,10,NYG,MIN,8
28,30,3,-2,BUF,ATL,9
13,14,3,-1,CHI,GB,9
7,28,1.5,-21,CIN,LAA,9
42,31,3,11,CLE,TB,9
35,31,10,4,HOU,DET,9
19,13,3,6,MIA,IND,9
23,21,4.5,2,MIN,LAN,9
20,13,3,7,NYG,PHX,9
26,27,7.5,-1,NE,NYJ,9
17,20,4,-3,PHA,SD,9
34,7,7.5,27,DEN,PIT,9
20,10,2.5,10,KC,SEA,9
3,13,14,-10,WAS,DAL,9
31,13,6,18,SF,NO,9
45,3,10.5,42,SF,ATL,10
20,0,3.5,20,CHI,PIT,10
17,7,2.5,10,CLE,SEA,10
24,20,7,4,PHX,DAL,10
13,16,0,-3,KC,DEN,10
22,31,1.5,-9,GB,DET,10
30,7,6.5,23,BUF,IND,10
31,23,3,8,MIA,NYJ,10
24,10,5.5,14,MIN,TB,10
28,24,2.5,4,NO,NE,10
31,10,2.5,21,LAN,NYG,10
3,10,5,-7,PHA,WAS,10
12,14,2.5,-2,LAA,SD,10
26,24,6,2,HOU,CIN,10
24,33,6,-9,BUF,NE,11
42,7,7,35,CIN,DET,11
17,21,10,-4,SF,GB,11
10,10,7,0,CLE,KC,11
23,7,5,16,HOU,LAA,11
17,14,6.5,3,MIA,DAL,11
9,10,1,-1,MIN,PHA,11
26,17,3,9,NO,ATL,11
37,14,10.5,23,LAN,PHX,11
20,17,2.5,3,PIT,SD,11
15,3,9,12,NYG,SEA,11
31,32,10,-1,CHI,TB,11
27,10,6,17,IND,NYJ,11
10,14,2.5,-4,WAS,DEN,11
10,13,6,-3,CLE,DET,12
27,0,6,27,PHA,DAL,12
27,7,2,20,NYJ,ATL,12
14,38,0,-24,CHI,WAS,12
24,7,3,17,BUF,CIN,12
0,34,1.5,-34,HOU,KC,12
19,20,3,-1,MIN,GB,12
24,21,6.5,3,LAA,NE,12
14,34,7.5,-20,MIA,PIT,12
10,6,4.5,4,IND,SD,12
41,14,9.5,27,DEN,SEA,12
13,14,1.5,-1,PHX,TB,12
20,17,0,3,LAN,NO,12
34,24,5,10,SF,NYG,12
0,21,4,-21,CLE,CIN,13
16,13,1.5,3,LAA,DEN,13
17,16,2.5,1,GB,TB,13
23,16,3,7,HOU,PIT,13
22,16,1.5,6,NE,IND,13
35,31,9.5,4,LAN,DAL,13
26,21,3.5,5,KC,MIA,13
14,21,4,-7,NO,DET,13
17,20,4.5,-3,SD,NYJ,13
17,24,3,-7,NYG,PHA,13
23,10,9.5,13,SF,ATL,13
29,10,4,19,WAS,PHX,13
27,16,6,11,MIN,CHI,13
16,17,5.5,-1,BUF,SEA,13
43,17,12,26,MIN,ATL,14
17,23,1,-6,CLE,IND,14
20,10,12,10,PHA,DAL,14
17,27,6.5,-10,CHI,DET,14
3,21,3,-18,GB,KC,14
19,22,6,-3,BUF,NO,14
7,14,3,-7,DEN,NYG,14
16,14,9,2,LAA,PHX,14
0,13,1.5,-13,NYJ,PIT,14
26,21,9.5,5,WAS,SD,14
17,24,10,-7,CIN,SEA,14
20,17,8,3,HOU,TB,14
31,10,5,21,MIA,NE,14
27,30,0,-3,LAN,SF,14
15,0,12,15,NYG,DAL,15
37,0,7,37,DEN,PHX,15
21,10,6.5,11,SF,BUF,15
28,40,1.5,-12,CHI,GB,15
61,7,3.5,54,CIN,HOU,15
42,13,0,29,IND,MIA,15
17,23,1.5,-6,MIN,CLE,15
28,10,3,18,PIT,NE,15
38,14,11,24,LAN,NYJ,15
13,20,7.5,-7,KC,SD,15
33,7,2.5,26,DET,TB,15
31,30,6.5,1,WAS,ATL,15
23,17,0,6,SEA,LAA,15
20,30,1,-10,PHA,NO,15
37,0,7,37,BUF,NYJ,16
0,29,2,-29,SEA,WAS,16
20,24,3.5,-4,HOU,CLE,16
26,0,9,26,SF,CHI,16
16,19,2.5,-3,DEN,SD,16
31,24,3,7,DET,ATL,16
20,10,7,10,GB,DAL,16
41,6,2.5,35,NO,IND,16
24,27,3.5,-3,MIA,KC,16
34,17,6.5,17,NYG,LAA,16
24,20,7,4,LAN,NE,16
31,14,12,17,PHA,PHX,16
31,22,2,9,PIT,TB,16
29,21,6,8,MIN,CIN,16
27,24,1,3,MIA,NE,1
21,38,6.5,-17,DET,TB,1
17,0,6,17,CHI,SEA,1
24,36,3,-12,LAN,GB,1
31,0,11.5,31,WAS,PHX,1
21,24,1.5,-3,MIN,KC,1
26,10,8,16,BUF,IND,1
14,17,3,-3,SD,DAL,1
9,14,1,-5,DEN,LAA,1
47,27,1,20,ATL,HOU,1
25,20,9,5,CIN,NYJ,1
13,3,3,10,CLE,PIT,1
27,20,4.5,7,NYG,PHA,1
13,12,4.5,1,SF,NO,1
14,16,2.5,-2,IND,NE,2
7,30,2,-23,BUF,MIA,2
21,16,3,5,CIN,SD,2
21,24,2,-3,CLE,NYJ,2
21,14,3,7,DET,ATL,2
13,31,3,-18,GB,CHI,2
35,14,3,21,LAN,TB,2
32,3,6,29,MIN,NO,2
28,7,8,21,NYG,DAL,2
21,23,13.5,-2,PHA,PHX,2
20,9,2.5,11,PIT,HOU,2
26,13,6.5,13,SF,WAS,2
17,13,0,4,LAA,SEA,2
24,23,5,1,DEN,KC,2
41,7,9.5,34,CIN,NE,3
19,16,2,3,CHI,MIN,3
14,24,5.5,-10,CLE,SD,3
34,31,9,3,DEN,SEA,3
3,17,3,-14,GB,KC,3
24,10,9,14,HOU,IND,3
20,3,3.5,17,LAA,PIT,3
21,27,5.5,-6,LAN,PHA,3
28,7,9,21,NO,PHX,3
20,3,7,17,NYG,MIA,3
19,13,10.5,6,SF,ATL,3
23,20,2,3,TB,DET,3
19,15,14,4,WAS,DAL,3
30,7,2,23,BUF,NYJ,3
37,13,1,24,NYJ,NE,4
29,28,3,1,BUF,DEN,4
21,24,2.5,-3,DET,GB,4
34,0,6.5,34,KC,CLE,4
24,10,1,14,LAA,CHI,4
28,6,2,22,MIA,PIT,4
20,23,8,-3,MIN,TB,4
31,17,13.5,14,NYG,DAL,4
23,24,13,-1,PHA,IND,4
7,17,2,-10,SD,HOU,4
38,10,7,28,WAS,PHX,4
16,31,2.5,-15,CIN,SEA,4
33,20,2.5,13,SEA,NE,5
28,27,2,1,ATL,NO,5
10,14,3,-4,TB,DAL,5
27,13,4,14,CHI,GB,5
19,23,6,-4,KC,IND,5
31,34,4.5,-3,LAN,CIN,5
20,16,6,4,MIA,NYJ,5
27,34,7,-7,MIN,DET,5
14,36,1.5,-22,SD,PIT,5
24,21,5.5,3,SF,HOU,5
38,24,3,14,BUF,LAA,5
29,30,9,-1,DEN,CLE,5
17,34,8.5,-17,DEN,PIT,6
48,17,3.5,31,HOU,CIN,6
43,24,6.5,19,KC,DET,6
24,17,5.5,7,LAA,SEA,6
25,20,6,5,NO,CLE,6
3,39,5,-36,NYJ,SD,6
20,3,2,17,PHX,DAL,6
45,35,6,10,SF,ATL,6
26,14,2,12,TB,GB,6
20,24,0,-4,WAS,NYG,6
38,9,2,29,CHI,LAN,6
32,24,4.5,8,PHA,MIN,6
17,10,10,7,MIA,NE,7
30,27,9,3,BUF,NYJ,7
27,17,0,10,DEN,IND,7
24,9,2.5,15,LAA,SD,7
44,24,7,20,LAN,ATL,7
20,19,13.5,1,NYG,PHX,7
27,7,10,20,SF,PIT,7
19,7,1.5,12,SEA,KC,7
13,17,8.5,-4,TB,DAL,7
13,7,4,6,WAS,PHA,7
23,10,6,13,HOU,NO,7
13,34,2.5,-21,CLE,CIN,7
27,10,6.5,17,BUF,NE,8
10,27,5.5,-17,NO,DET,8
27,7,2.5,20,MIA,IND,8
24,10,2.5,14,GB,MIN,8
12,17,9,-5,HOU,NYJ,8
21,20,3.5,1,PHA,DAL,8
31,21,6,10,CHI,PHX,8
20,17,13,3,SF,CLE,8
41,10,4,31,SD,TB,8
21,10,3.5,11,NYG,WAS,8
17,38,0,-21,CIN,ATL,8
10,41,0,-31,LAN,PIT,8
48,20,9.5,28,PHA,NE,9
42,0,3,42,BUF,CLE,9
26,6,5,20,CHI,TB,9
7,21,7.5,-14,CIN,NO,9
9,7,2,2,KC,LAA,9
17,13,3,4,LAN,HOU,9
23,3,9.5,20,MIA,PHX,9
24,9,4.5,15,NYJ,DAL,9
21,9,4,12,PIT,ATL,9
24,20,6.5,4,SF,GB,9
14,31,5,-17,SEA,SD,9
41,38,2.5,3,WAS,DET,9
22,27,1,-5,DEN,MIN,9
24,7,9,17,NYG,IND,9
10,13,1,-3,NE,IND,10
17,3,3,14,MIA,NYJ,10
7,17,3.5,-10,DET,MIN,10
16,17,6.5,-1,KC,SEA,10
35,7,7,28,NO,TB,10
30,24,9,6,CHI,ATL,10
45,14,12.5,31,BUF,PHX,10
31,7,3,24,NYG,LAN,10
19,7,3,12,SD,DEN,10
16,29,7,-13,LAA,GB,10
24,6,10,18,SF,DAL,10
28,14,3,14,PHA,WAS,10
14,0,14.5,14,BUF,NE,11
16,13,2.5,3,CHI,DEN,11
24,21,5,3,GB,PHX,11
35,23,3,12,HOU,CLE,11
27,10,4,17,KC,SD,11
21,24,9,-3,LAN,DAL,11
20,0,13,20,NYG,DET,11
14,17,2,-3,NYJ,IND,11
24,23,1,1,PHA,ATL,11
31,7,14,24,SF,TB,11
21,24,3.5,-3,SEA,MIN,11
31,17,5,14,WAS,NO,11
27,3,2.5,24,CIN,PIT,11
10,13,3.5,-3,MIA,LAA,11
27,40,0,-13,DEN,DET,12
17,27,6,-10,WAS,DAL,12
34,14,5,20,PHX,NE,12
13,41,2.5,-28,CHI,MIN,12
20,34,11.5,-14,CIN,IND,12
20,10,7.5,10,GB,TB,12
24,27,4,-3,LAA,KC,12
30,13,5.5,17,MIA,CLE,12
10,7,6,3,NO,ATL,12
13,31,3,-18,NYG,PHA,12
24,7,3,17,PIT,NYJ,12
17,28,11,-11,SF,LAN,12
10,13,4,-3,SD,SEA,12
27,24,3,3,HOU,BUF,12
37,7,7,30,KC,NE,13
17,23,2.5,-6,ATL,TB,13
30,23,3,7,BUF,PHA,13
23,17,8.5,6,CHI,DET,13
23,20,2.5,3,LAA,DEN,13
38,23,3.5,15,LAN,CLE,13
23,7,5,16,MIN,GB,13
13,17,1,-4,NO,DAL,13
12,16,4,-4,PIT,CIN,13
20,17,2.5,3,PHX,IND,13
38,17,6.5,21,SD,NYJ,13
13,10,0,3,SEA,HOU,13
42,20,3,22,WAS,MIA,13
7,3,3.5,4,SF,NYG,13
24,3,13.5,21,PIT,NE,14
13,24,4.5,-11,ATL,PHX,14
31,7,5.5,24,BUF,IND,14
14,20,3.5,-6,GB,SEA,14
58,14,13,44,HOU,CLE,14
31,20,7.5,11,KC,DEN,14
20,24,5,-4,LAN,NO,14
23,20,2,3,MIA,PHA,14
23,15,6.5,8,NYG,MIN,14
20,17,4,3,SF,CIN,14
10,9,4,1,WAS,CHI,14
38,31,3,7,LAA,DET,14
13,17,3.5,-4,NYG,BUF,15
25,10,13,15,WAS,NE,15
10,13,1,-3,ATL,CLE,15
21,38,3,-17,CHI,DET,15
41,10,5.5,31,DAL,PHX,15
20,10,0,10,DEN,SD,15
10,27,3.5,-17,KC,HOU,15
24,7,5.5,17,LAA,CIN,15
24,17,5.5,7,MIA,SEA,15
13,26,6,-13,MIN,TB,15
6,9,2.5,-3,NO,PIT,15
21,29,3.5,-8,NYJ,IND,15
31,0,10,31,PHA,GB,15
26,10,6,16,SF,LAN,15
24,17,3.5,7,DET,GB,16
28,24,0,4,LAA,MIN,16
28,35,6,-7,WAS,IND,16
42,7,7,35,NYJ,NE,16
24,14,3.5,10,BUF,MIA,16
27,14,7,13,CHI,TB,16
20,40,2.5,-20,HOU,CIN,16
24,21,2,3,KC,SD,16
13,20,3.5,-7,LAN,ATL,16
17,3,7,14,PHA,DAL,16
35,0,10.5,35,PIT,CLE,16
24,21,6.5,3,NYG,PHX,16
10,13,9,-3,SF,NO,16
17,12,5,5,SEA,DEN,16
21,10,1,11,KC,CHI,17
23,21,7.5,2,PHA,PHX,17
23,17,7.5,6,MIA,IND,17
29,14,5,15,WAS,BUF,17
21,14,16.5,7,CIN,CLE,17
26,7,1,19,ATL,DAL,17
13,10,14,3,NYG,NE,17
20,17,3,3,SF,MIN,17
30,10,3,20,SEA,DET,17
22,13,7.5,9,DEN,GB,17
14,16,3.5,-2,TB,NYJ,17
17,12,9.5,5,LAA,SD,17
14,34,1.5,-20,PIT,HOU,17
20,17,6,3,NO,LAN,17
7,16,9,-9,IND,NE,1
16,13,2.5,3,NYJ,TB,1
26,14,2,12,DAL,CLE,1
27,24,3.5,3,NO,SEA,1
14,3,7,11,KC,ATL,1
20,3,1.5,17,PHA,GB,1
10,6,2,4,CHI,MIN,1
26,20,5,6,PIT,SD,1
45,14,2,31,DEN,CIN,1
14,24,7,-10,LAN,PHX,1
47,17,2.5,30,HOU,LAA,1
35,31,7,4,BUF,MIA,1
45,0,7.5,45,WAS,DET,1
16,14,2,2,NYG,SF,1
0,20,1,-20,NE,CLE,2
10,17,6,-7,KC,NO,2
10,26,6,-16,PHA,PHX,2
19,20,1,-1,ATL,MIN,2
17,6,8,11,MIA,IND,2
52,34,7,18,BUF,PIT,2
23,14,2,9,DET,GB,2
13,19,7,-6,NYG,LAN,2
21,20,3,1,CHI,TB,2
16,13,4,3,LAA,DEN,2
34,14,12,20,SF,SD,2
20,13,5,7,SEA,NYJ,2
7,30,2,-23,CIN,HOU,2
33,31,2,2,WAS,DAL,2
20,6,14,14,PIT,NE,3
13,14,3.5,-1,CIN,CLE,3
34,0,9,34,WAS,PHX,3
13,17,2,-4,MIA,DET,3
14,17,3,-3,SF,MIN,3
0,24,3,-24,DAL,PHA,3
17,20,1.5,-3,NYG,CHI,3
15,13,3.5,2,GB,TB,3
10,13,2,-3,SD,ATL,3
16,0,7.5,16,LAA,IND,3
16,10,6,6,DEN,SEA,3
23,20,8,3,BUF,NYJ,3
24,7,3,17,NO,LAN,3
17,7,4,10,HOU,KC,3
20,24,12.5,-4,HOU,NE,4
17,10,8,7,BUF,TB,4
27,19,9,8,DEN,SD,4
33,24,1.5,9,DET,IND,4
20,13,8,7,KC,SEA,4
17,21,2,-4,LAA,ATL,4
16,13,7.5,3,MIA,GB,4
26,0,3,26,NO,MIN,4
13,10,12.5,3,NYG,CLE,4
23,14,3,9,PHA,PIT,4
27,10,8.5,17,SF,LAN,4
34,27,4,7,WAS,CIN,4
9,17,1,-8,PHX,DAL,4
19,13,8,6,CHI,NYJ,4
24,10,7.5,14,PHX,NE,5
35,20,7.5,15,BUF,CHI,5
31,3,5,28,DET,TB,5
14,13,4.5,1,KC,SD,5
23,21,4,2,LAN,GB,5
23,41,3,-18,MIA,NYJ,5
16,21,2.5,-5,NYG,DAL,5
27,6,1.5,21,NO,ATL,5
6,12,1.5,-6,SF,LAA,5
31,3,7,28,SEA,IND,5
6,13,5,-7,MIN,DEN,5
23,0,6,23,WAS,PHA,5
20,10,6.5,10,MIA,NE,6
42,14,7.5,28,HOU,DEN,6
20,17,2.5,3,DAL,GB,6
24,20,3,4,DET,MIN,6
17,14,1.5,3,NYJ,CLE,6
13,14,4,-1,PHA,TB,6
7,13,3,-6,CIN,SEA,6
20,7,2.5,13,WAS,CHI,6
20,9,9.5,11,NYG,PHX,6
13,21,7.5,-8,LAA,SD,6
21,3,6,18,PIT,IND,6
6,33,3,-27,BUF,KC,6
42,6,19.5,36,BUF,IND,7
35,23,6.5,12,DAL,CIN,7
23,20,3,3,HOU,NYJ,7
42,7,6.5,35,KC,MIA,7
30,24,3.5,6,LAN,SD,7
34,7,7,27,MIN,PHX,7
13,6,4,7,NO,PHA,7
34,39,10.5,-5,SF,ATL,7
42,17,13.5,25,WAS,CLE,7
20,23,2.5,-3,SEA,LAA,7
23,20,3.5,3,NYG,PIT,7
10,0,5.5,10,CHI,GB,8
23,26,7,-3,MIN,NE,8
17,6,12,11,NYJ,IND,8
23,7,12.5,16,NO,TB,8
24,30,5.5,-6,SD,CLE,8
16,19,1,-3,KC,DEN,8
17,13,4,4,HOU,MIA,8
7,27,4,-20,PIT,SEA,8
10,16,2,-6,ATL,PHX,8
35,3,7,32,SF,DET,8
20,17,4,3,LAA,LAN,8
35,16,13,19,BUF,CIN,8
9,6,6.5,3,DEN,NE,9
35,3,13,32,HOU,CIN,9
17,20,6.5,-3,NO,CHI,9
0,27,2.5,-27,TB,GB,9
31,14,2,17,ATL,LAN,9
17,14,1.5,3,CLE,PIT,9
23,7,4,16,SF,PHA,9
34,10,2.5,24,DET,DAL,9
28,0,2.5,28,MIN,PHX,9
20,9,6,11,SEA,SD,9
13,17,1.5,-4,NYG,WAS,9
24,21,6.5,3,KC,LAA,9
22,17,17.5,5,BUF,NE,10
14,17,5,-3,SF,ATL,10
21,23,2.5,-2,CLE,CIN,10
20,10,6,10,CHI,DET,10
19,16,7,3,NYJ,GB,10
16,13,6.5,3,WAS,HOU,10
27,7,9,20,DAL,PHX,10
28,13,11.5,15,MIN,TB,10
24,17,4,7,NO,LAN,10
10,6,10,4,MIA,IND,10
20,13,6.5,7,DEN,PIT,10
7,30,4,-23,NYG,PHA,10
30,20,6.5,10,MIA,NE,11
34,24,7,10,BUF,GB,11
27,33,1.5,-6,CIN,PIT,11
30,32,1,-2,CLE,PHA,11
16,17,3,-1,DEN,LAA,11
21,30,3.5,-9,DET,TB,11
26,23,9,3,HOU,DAL,11
27,20,4,7,KC,LAN,11
10,3,5.5,7,NO,SF,11
21,14,7,7,NYG,PHX,11
27,28,13.5,-1,NYJ,IND,11
14,17,2,-3,SEA,SD,11
56,17,12,39,WAS,ATL,11
17,34,3,-17,MIN,CHI,11
28,21,2.5,7,NYJ,NE,12
43,7,6,36,ATL,TB,12
31,17,9.5,14,CHI,IND,12
21,10,4,11,DET,LAN,12
28,24,13,4,HOU,CLE,12
20,24,6.5,-4,KC,DEN,12
31,7,4,24,LAA,SEA,12
35,21,3,14,MIN,GB,12
21,24,4.5,-3,NO,SD,12
22,9,6,13,NYG,DAL,12
17,10,9,7,PHA,CIN,12
14,10,10.5,4,SF,PHX,12
41,14,7,27,WAS,PIT,12
41,27,4,14,BUF,MIA,12
13,16,8,-3,BUF,NE,13
21,24,12,-3,WAS,DAL,13
14,34,6,-20,MIN,DET,13
14,26,6.5,-12,HOU,PIT,13
14,10,7,4,GB,IND,13
15,20,4,-5,KC,CLE,13
38,14,6.5,24,LAA,CIN,13
13,16,7.5,-3,CHI,MIA,13
21,14,9,7,NYG,TB,13
34,14,6,20,PHA,PHX,13
13,10,3,3,SEA,DEN,13
24,3,4.5,21,NYJ,SD,13
20,23,6.5,-3,NO,ATL,13
33,10,3,23,SF,LAN,13
16,6,3,10,DET,CHI,14
20,10,6.5,10,DAL,PIT,14
20,3,8,17,DEN,NE,14
31,0,5.5,31,CLE,IND,14
24,13,9,11,BUF,NYJ,14
33,14,9.5,19,MIA,TB,14
27,6,11,21,WAS,LAN,14
6,19,1.5,-13,SEA,KC,14
38,24,5,14,SF,NO,14
24,27,7,-3,NYG,CIN,14
35,31,8.5,4,ATL,GB,14
9,7,5,2,LAA,SD,14
6,13,6.5,-7,HOU,PHA,14
23,17,7.5,6,NE,IND,15
7,17,0,-10,CLE,DEN,15
27,13,9.5,14,CHI,GB,15
23,14,2,9,DAL,NO,15
14,19,3,-5,NYG,PHA,15
31,6,10,25,HOU,PIT,15
20,17,9,3,KC,SD,15
20,14,14,6,WAS,PHX,15
31,14,6,17,ATL,LAN,15
27,30,2,-3,LAA,BUF,15
34,20,5,14,DET,NYJ,15
24,22,3.5,2,SF,SEA,15
26,24,4.5,2,MIN,TB,15
37,13,7.5,24,MIA,CIN,15
27,0,12,27,CHI,TB,16
28,14,4.5,14,SF,KC,16
3,6,6.5,-3,NYJ,NE,16
17,10,5.5,7,PIT,CIN,16
13,25,3.5,-12,PHA,DAL,16
26,13,6,13,ATL,SEA,16
21,17,3,4,DET,GB,16
17,14,3,3,HOU,CLE,16
24,19,11.5,5,DEN,PHX,16
20,14,9.5,6,MIN,LAN,16
34,17,9,17,WAS,NYG,16
30,38,0,-8,MIA,SD,16
35,7,12,28,BUF,IND,16
27,0,2,27,NO,LAA,16
20,24,3,-4,HOU,NYG,17
7,27,6,-20,MIN,GB,17
21,27,3.5,-6,LAA,KC,17
17,3,5.5,14,TB,IND,17
22,24,3,-2,WAS,PHA,17
31,27,3.5,4,DAL,ATL,17
27,3,6.5,24,NO,PHX,17
17,10,3,7,PIT,CLE,17
20,23,6,-3,MIA,NYJ,17
14,17,6.5,-3,BUF,DET,17
17,14,2,3,DEN,SD,17
7,29,2,-22,NE,CIN,17
23,9,6,14,SEA,LAN,17
52,14,5,38,SF,CHI,17
15,13,4,2,PHA,NO,1
40,7,11.5,33,BUF,LAN,1
27,24,3.5,3,CHI,DET,1
20,17,3,3,ATL,NYJ,1
24,29,11,-5,HOU,PIT,1
23,20,2,3,MIN,GB,1
3,14,5.5,-11,CLE,IND,1
31,14,3,17,SF,NYG,1
24,10,2.5,14,KC,SD,1
3,21,4,-18,SEA,CIN,1
23,7,1.5,16,TB,PHX,1
17,13,3.5,4,DEN,LAA,1
10,23,2.5,-13,WAS,DAL,1
14,0,3.5,14,LAN,NE,2
24,17,10,7,WAS,ATL,2
34,28,3,6,DAL,NYG,2
28,6,4,22,NO,CHI,2
21,24,2.5,-3,LAA,CIN,2
31,17,3,14,DET,MIN,2
26,7,10.5,19,KC,SEA,2
31,3,2.5,28,TB,GB,2
31,34,3.5,-3,SF,BUF,2
21,13,6.5,8,DEN,SD,2
20,10,9,10,HOU,IND,2
10,27,1.5,-17,NYJ,PIT,2
31,14,6.5,17,PHA,PHX,2
27,23,2.5,4,MIA,CLE,2
6,10,3,-4,NE,SEA,3
23,24,0,-1,CIN,GB,3
30,0,6.5,30,PHA,DEN,3
23,20,5,3,HOU,KC,3
7,10,1.5,-3,ATL,NO,3
31,14,4.5,17,SF,NYJ,3
26,20,7,6,MIN,TB,3
16,28,8,-12,LAA,CLE,3
13,10,9,3,WAS,DET,3
26,10,8.5,16,MIA,LAN,3
31,20,14,11,DAL,PHX,3
6,23,3,-17,SD,PIT,3
38,0,17,38,BUF,IND,3
14,27,5,-13,CHI,NYG,3
41,7,15,34,BUF,NE,4
41,31,4,10,CHI,ATL,4
12,0,3.5,12,DEN,CLE,4
27,0,12,27,HOU,SD,4
7,42,1.5,-35,CIN,MIN,4
23,27,10,-4,DET,TB,4
19,17,6,2,MIA,SEA,4
10,18,0,-8,NYJ,LAN,4
3,17,3.5,-14,PIT,GB,4
16,10,3,6,SF,NO,4
27,7,7,20,KC,LAA,4
10,37,11,-27,BUF,MIA,5
21,20,4,1,MIN,CHI,5
24,10,7.5,14,ATL,GB,5
14,24,9.5,-10,TB,IND,5
7,13,0,-6,DET,NO,5
20,19,1,1,DEN,KC,5
27,24,15,3,SF,LAN,5
13,10,1,3,LAA,NYG,5
17,6,3.5,11,SD,SEA,5
24,27,10,-3,WAS,PHX,5
30,21,8.5,9,NYJ,NE,5
31,7,4.5,24,PHA,DAL,5
24,12,16,12,SF,NE,6
3,20,8.5,-17,BUF,LAA,6
27,0,15,27,DAL,SEA,6
38,24,6.5,14,HOU,CIN,6
21,17,7.5,4,MIA,ATL,6
31,21,7,10,NYG,PHX,6
3,6,2.5,-3,NYJ,IND,6
17,24,2.5,-7,PHA,KC,6
9,17,2.5,-8,PIT,CLE,6
13,10,9.5,3,NO,LAN,6
34,3,9,31,WAS,DEN,6
31,14,5.5,17,MIN,DET,7
16,12,1.5,4,WAS,PHA,7
17,10,4,7,DAL,KC,7
31,14,5.5,17,CHI,TB,7
17,6,3,11,CLE,GB,7
14,34,2,-20,IND,SD,7
56,17,10,39,SF,ATL,7
21,27,2,-6,HOU,DEN,7
17,38,1.5,-21,NYG,LAN,7
19,0,7,19,LAA,SEA,7
30,21,7,9,NO,PHX,7
38,17,15,21,MIA,NE,7
20,0,7.5,20,PIT,CIN,7
19,17,6,2,CLE,NE,8
30,10,3.5,20,CHI,GB,8
28,13,2.5,15,DAL,LAA,8
21,24,1,-3,DEN,SD,8
26,10,16,16,HOU,CIN,8
20,31,13.5,-11,MIA,IND,8
23,10,15,13,NYG,SEA,8
7,3,16,4,PHA,PHX,8
7,38,3,-31,TB,DET,8
15,13,2.5,2,WAS,MIN,8
3,27,7.5,-24,KC,PIT,8
24,20,8,4,BUF,NYJ,8
16,7,19.5,9,BUF,NE,9
13,27,9,-14,DET,GB,9
20,21,2.5,-1,HOU,PIT,9
30,28,4,2,ATL,LAN,9
14,26,6,-12,MIA,NYJ,9
23,21,11,2,NO,TB,9
10,30,1.5,-20,CLE,CIN,9
26,0,6,26,SD,IND,9
20,10,3.5,10,DAL,PHA,9
14,24,12.5,-10,SF,PHX,9
7,24,10.5,-17,WAS,NYG,9
10,38,3.5,-28,CHI,MIN,9
31,14,8,17,NO,NE,10
28,20,7,8,BUF,PIT,10
37,3,6.5,34,DAL,DET,10
27,16,6,11,DEN,NYJ,10
14,24,11,-10,HOU,CLE,10
16,14,6,2,KC,SD,10
14,20,5,-6,LAN,PHX,10
28,0,6.5,28,MIA,IND,10
35,7,6,28,MIN,TB,10
27,7,9,20,NYG,GB,10
31,10,6.5,21,PHA,LAA,10
16,3,12.5,13,WAS,SEA,10
28,31,10,-3,CHI,CIN,10
41,3,7,38,SF,ATL,10
17,20,6,-3,CHI,TB,11
35,16,1,19,KC,WAS,11
24,27,8,-3,PHA,GB,11
13,17,6.5,-4,MIN,HOU,11
13,14,2,-1,CLE,SD,11
20,17,7,3,ATL,PHX,11
34,37,7,-3,IND,NE,11
21,20,6.5,1,SF,NO,11
20,3,13,17,LAA,SEA,11
17,14,6.5,3,NYJ,CIN,11
17,14,10,3,PIT,DET,11
23,27,14,-4,DAL,LAN,11
27,13,3.5,14,DEN,NYG,11
26,20,1,6,BUF,MIA,11
13,19,2.5,-6,CIN,DET,12
3,24,4.5,-21,NYJ,NE,12
47,34,3.5,13,PHA,NYG,12
27,10,6.5,17,SF,LAN,12
16,10,8,6,DAL,PHX,12
24,0,4,24,LAA,DEN,12
19,16,4,3,MIA,HOU,12
29,14,8,15,SD,TB,12
3,17,5.5,-14,CHI,GB,12
17,13,9,4,MIN,CLE,12
30,14,11.5,16,PIT,IND,12
41,14,13.5,27,BUF,ATL,12
24,14,12,10,KC,SEA,12
20,3,4,17,NO,WAS,12
24,21,2.5,3,HOU,DET,13
30,3,15,27,DAL,NYG,13
27,14,3.5,13,CLE,CHI,13
23,7,5.5,16,KC,NYJ,13
31,17,2,14,MIN,LAN,13
21,9,7,12,PIT,CIN,13
13,16,16,-3,BUF,IND,13
19,14,5,5,GB,TB,13
24,13,3.5,11,NO,MIA,13
20,14,6.5,6,SF,PHA,13
34,0,5.5,34,ATL,NE,13
41,3,8.5,38,WAS,PHX,13
27,3,3.5,24,SD,LAA,13
13,16,5,-3,DEN,SEA,13
22,14,10,8,NO,ATL,14
0,6,1,-6,NE,IND,14
31,27,4.5,4,DAL,DEN,14
28,10,6.5,18,WAS,NYG,14
7,28,2.5,-21,KC,LAA,14
38,10,3.5,28,GB,DET,14
27,21,4.5,6,SD,PHX,14
28,17,5.5,11,PHA,MIN,14
37,21,10,16,CLE,CIN,14
27,3,8,24,SF,MIA,14
17,24,17.5,-7,BUF,NYJ,14
20,14,13.5,6,PIT,SEA,14
27,31,1,-4,TB,LAN,14
24,7,11,17,HOU,CHI,14
27,17,14,10,BUF,DEN,15
0,19,3.5,-19,NYG,PHX,15
20,17,3.5,3,WAS,DAL,15
20,17,5.5,3,SF,MIN,15
37,14,5,23,NO,LAN,15
20,17,9.5,3,PHA,SEA,15
6,30,4,-24,PIT,CHI,15
7,35,0,-28,TB,ATL,15
14,24,2.5,-10,CLE,DET,15
6,10,5.5,-4,NYJ,IND,15
27,10,14,17,SD,CIN,15
27,20,16,7,KC,NE,15
14,16,7,-2,HOU,GB,15
20,7,6,13,MIA,LAA,15
21,35,9,-14,KC,NYG,16
21,14,20,7,SF,TB,16
16,20,3,-4,NO,BUF,16
16,3,2.5,13,DET,CHI,16
17,14,1.5,3,HOU,CLE,16
16,13,2.5,3,IND,PHX,16
3,6,1.5,-3,PIT,MIN,16
20,10,4.5,10,CIN,NE,16
28,13,6.5,15,GB,LAN,16
36,14,3,22,SD,LAA,16
17,13,3,4,PHA,WAS,16
10,6,8.5,4,DEN,SEA,16
19,17,11.5,2,MIA,NYJ,16
41,17,7,24,DAL,ATL,16
20,0,7.5,20,NO,NYJ,17
20,21,14,-1,WAS,LAA,17
16,13,10,3,MIA,NE,17
21,17,1.5,4,IND,CIN,17
38,27,1.5,11,LAN,ATL,17
42,20,7,22,KC,DEN,17
3,7,6.5,-4,PHX,TB,17
27,14,11.5,13,DAL,CHI,17
20,10,8.5,10,PHA,NYG,17
23,13,6.5,10,PIT,CLE,17
27,7,2,20,MIN,GB,17
31,14,9.5,17,SD,SEA,17
3,27,4,-24,BUF,HOU,17
24,6,13.5,18,SF,DET,17
